7 10
-1
==========
=     ^MK=
=X^   ====
=  WT    =
=====****=
=@  #^$!X=
==========