15 20
180
====================
=X =        !      =
=     ^^^        $!=
====================
=WT= X K          $=
=*==      ^        =
=     ****=======  =
=                  =
=====X            $=
=        ===========
=            ^     =
=   ***********    =
=##     ^         $=
=@#     D     M  X =
====================