10 12
120
============
= KMW    D =
=X         =
====     ^!=
=T ^      $=
=#*****=====
=      #  @=
=$   =======
= ^   *$! X=
============